R 1280 800

NO ./textures/brick.txt
SO ./textures/metal.txt
WE ./textures/stone.txt
EA ./textures/wood.txt
S ./textures/sprites/pillar.txt

C 138,71,12
F 255,45,89

        1111111111111111111111111
        1000000000110000000000001
        1011000001110000002000001
        1001000000000000000000001
111111111011000001110000000000001
100000001011000001111111111111111
11110111 11111110111   100101
11110111111111011111  1001001
11000000110101011101  1001001
10002000000000001101 10010001
10000000000000001101110010001
11000001110101011111011110N0111
11110111 1110101 101111010001
11111111 1111111 111111111111